邮件服务器已拒绝该邮件	qa
无法发送电子邮件	qa
系统激活	qa
系统许可	qa
怎么移除打印机	qa
打印机怎么移除	qa
服务器申请流程	qa
服务器申请需要什么流程	qa
服务器申请流程是什么样的	qa
服务器申请流程说明	qa
标签型号修改流程商机编号问题	qa
怎么修改商机标签型号	qa
如何修改商机标签型号	qa
流程商机的标签型号怎么修改	qa
流程商机的编号怎么修改	qa
打印字符不全或字符不清晰或字迹偏淡	qa
打印机打印的文件模糊	qa
打印机字符不清楚	qa
打印机打印字符不全	qa
打印机字符空缺	qa
经验案例申请人主管调整	qa
怎么修改经验案例申请人主管	qa
经验案例申请人主管怎么修改	qa
样机申请单选择不到需要选择的样机	qa
样机申请单选择不到样机怎么办	qa
样机申请单没有需要的样机	qa
样机申请单找不到我要的样机	qa
备货申请物料版本问题	qa
备货申请物料版本有问题	qa
物料版本有问题	qa
怎样申请备货物料版本	qa
申请物料版本出现问题	qa
新建提交研发物料流程时系统提示内部订单号异常	qa
海康官方网站访问速度慢	qa
访问海康官网速度慢	qa
人员能力集	qa
打印机卡纸	qa
打印机卡纸了怎么办法	qa
打印机卡纸了怎么整	qa
打印机卡纸了怎么解决	qa
印章管理员配置涉及系统	qa
印章管理员系统都有哪些	qa
印章管理员系统都包含哪些	qa
印章管理员系统	qa
印章管理员相关系统链接	qa
印章管理员相关系统	qa
总部运营商务人员配置相关系统	qa
总部运营商务人员包括的系统	qa
总部运营商务人员包括的系统有哪些	qa
运营商务人员系统都有哪些	qa
运营商务人员系统	qa
商务人员系统	qa
任务里的扫一扫	qa
变更任务信息	qa
任务信息变更	qa
个人视图显示	qa
个人视图怎么显示	qa
个人视图显示规则	qa
签到签退	qa
签到数据导出	qa
签到签退数据	qa
邮件接收延迟	qa
邮件接收时间	qa
修改邮件接收时间	qa
研发管理系统经验案例异常	qa
经验案例系统异常	qa
研发管理系统异常	qa
研发管理系统经验案例	qa
退返品流程	qa
退返品流程异常	qa
配置公共邮箱	qa
公共邮箱	qa
添加公共邮箱	qa
数据导入不成功	qa
数据导入失败	qa
数据导入报错	qa
无线网卡	qa
万能驱动	qa
电脑网络上不了	qa
小红叉	qa
网络打叉	qa
沙盒模式	qa
无盘机特别卡	qa
无盘机卡顿	qa
无盘机非常卡	qa
无盘机反应特别慢	qa
敏感数据外发至公司外正确途径和注意事项	qa
敏感数据怎么外发	qa
外发敏感数据	qa
敏感数据外发需要注意什么	qa
外发敏感数据需要注意什么	qa
可以外发敏感数据么	qa
敏感数据可以发送带外网么	qa
可以往外网发送敏感数据么	qa
外包域账号和公共域账号如何修改密码	qa
外包域账号如何修改密码	qa
公共域账号如何修改密码	qa
外包域账号和公共域账号修改密码	qa
外包域账号修改密码	qa
公共域账号修改密码	qa
修改外包域账号和公共域账号的密码	qa
修改外包域账号密码	qa
修改公共域账号密码	qa
如何申请对外域名接入网宿云防护	qa
怎么申请对外域名接入网宿云防护	qa
申请对外域名接入网宿云防护	qa
申请网宿云防护	qa
国内开票系统提示生成凭证失败	qa
开票系统提示生成凭证失败	qa
开票提示生成凭证失败	qa
邮箱打开报错颁发该安全证书的公司不是您信任的公司	qa
邮箱打开报证书错误	qa
邮箱打开报错	qa
邮箱打开报错，证书不可信	qa
打印机补丁包无法安装	qa
打印机补丁包下载终止	qa
打印机补丁无法下载	qa
打印机补丁包无法下载	qa
合资公司开通总部红版流程使用权限说明	qa
合资公司怎么开通总部红版	qa
合资公司怎么开通总部红版权限	qa
合资公司怎么使用总部红版	qa
资产转移申请	qa
资产转移	qa
怎么转移资产	qa
资产怎么转移	qa
资产怎么转移给其他同事	qa
谷歌浏览器输入卡死	qa
谷歌浏览器输入内容卡死	qa
谷歌输入内容就卡死	qa
谷歌输入内容无响应	qa
谷歌浏览器输入内容无响应	qa
不动产承租系统说明	qa
公司不动产租赁	qa
公司不动产承租	qa
租赁公司不动产	qa
承租公司不动产	qa
设备管理权限配置说明	qa
园区设备管理权限配置说明	qa
设备管理权限配置	qa
园区设备管理权限配置	qa
其他合同评审系统配置说明	qa
怎么进行其他合同评审	qa
怎么申请其他合同的评审	qa
其他合同评审	qa
文档打不开提示证书颁发商不可信或身份不明	qa
文档打不开，身份不明	qa
身份不明文档无法打开	qa
证书不可信文档无法打开	qa
图片打不开，显示内存不足	qa
内存不足图片打不开	qa
打不开图片内存不足怎么解决	qa
待办系统相关问题	qa
怎么查看待办事项	qa
待办事项怎么删除	qa
待办事项空白	qa
无法打开待办事项	qa
授权配置操作说明	qa
授权配置	qa
配置授权信息	qa
如何操作配置授权	qa
怎么配置授权信息	qa
行政类合同系统配置	qa
行政类合同怎么填写	qa
行政类合同都需要包含哪些信息	qa
差旅申请相关说明	qa
怎么进行差旅申请	qa
差旅申请怎么填写	qa
差旅申请都需要什么	qa
出差申请	qa
出差申请在哪里	qa
怎么申请出差	qa
出差返回日期不确定	qa
群邮件代发	qa
审批代发的群邮件	qa
群邮件代发审批	qa
流程信息查询	qa
流程查询	qa
怎么查询流程信息	qa
流程信息怎么查询	qa
查看流程信息	qa
怎么查看流程信息	qa
国内工程装修合同评审系统配置说明	qa
国内装修合同评审	qa
工程装修合同评审系统	qa
工程装修合同评审	qa
系统时间不同步	qa
系统时间怎么同步	qa
同步系统时间怎么搞	qa
怎么同步系统时间	qa
管理策略不允许使用下面的程序，对他们的访问已经终止	qa
程序访问被终止，管理策略不允许	qa
管理策略不允许，访问被终止	qa
管理策略不允许访问	qa
微信登陆不了	qa
微信无法登陆	qa
微信登陆异常	qa
微信异常	qa
角色及权限管理操作说明	qa
角色管理系统	qa
权限管理系统说明	qa
权限管理系统	qa
印章静默签开启	qa
印章静默签怎么开启	qa
内网邮箱收不到特定的邮件	qa
邮箱收不到特定邮件	qa
特定邮件收不到	qa
收不到特定邮件怎么搞	qa
无法收到特定邮件怎么解决	qa
特定邮件邮件收不到怎么办	qa
附件无法上传	qa
浏览器无法上传附件	qa
公司系统无法上传附件	qa
国内客户出海外产品配单相关问题	qa
国内客户怎么出海外产品配单	qa
海外产品配单	qa
资质管理证书系统下载权限说明	qa
资质管理证书系统无法下载	qa
怎么下载资质管理证书	qa
资质管理证书怎么下载	qa
资质证书怎么下载	qa
下载资质证书	qa
会花诶查看	other
增加其他特征进行了拼错了差噪音吗	other
不是什么百分之	other
上海伤害	other
但对我来说理解还有点难	other
你真是穿有内存中还是有问题的	other
这个结果也可增加其他特征继续搜索果然有问题清楚掉啊哦啊哦啊	other
我这个清理思维哦诶哦诶	other
我还不能理解哦	other
但是结果也可增加其他都继续搜索	other
他就会发挥遗产使队友结果我一定能一说其他特征继续搜索哦	other
我这个话筒还要回灌救你深圳市	other
从来没有吃过哇妈的怎么不说声音了那天主动和你在吹牛了啊现在有了呀	other
为您展示对应结果你也可以说其他的就进去搜索跟唤醒啊	other
打开的鸡肉啊	other
妈妈吓一跳海	other
你要打开的进入谢谢谢谢你说完啪的关掉你不说话了个把关掉	other
不好意思换一种问法试试	other
那你等会儿	other
上来	other
我先下去了啊	other
都是把这个带上吧	other
要不就是我爸88司令	other
检查打针就带上干嘛哦你	other
你在2天还用这个还是有点困难哦	other
想一想啊	other
我还不能理解	other
我教你	other
想害你	other
都不能理解	other
那您能理解啥	other
滚	other
你还要去工作吧	other
我不要讲很久	other
但是我至少要先唤醒一下	other
娃娃特像那个清空的问题	other
甚至有没有提升你	other
你有那个车呀	other
你有才是那个	other
这一锅还	other
啊哦	other
我高兴啊	other
那个那个还在调那个战争那会儿哦累	other
你就不会只要把这里达到这个收入花里面去啊	other
但是不用抄个小孩他只要没有变成哪里只要是红色你就会	other
语言只是一种高鼠标哇	other
就是语音能力吧就是语音	other
其实就等于用声音代替鼠标第一个的最基本的	other
你只有一分钟的时间哦累	other
那晚上都老兵已经把我屁都没醒来	other
没收总之我永远是被打伤了之后感觉乱七八糟	other
更别说接着跟我说	other
还必须再次汇聚	other
那么丑啊	other
你以为你没了	other
你为你没了然后命中了那个第一条儿	other
我给你做这个词悔改实在感人啊哦	other
就没有票了哦	other
哦转视她的国土活动信息	other
联邦快递慢了	other
忘了哦累哦累	other
但是从	other
正常的话	other
忘了哦累哦累	other
诶你你你你这边日志显示你的计划	other
其他的爱其他的意图方面你就没事	other
看不出来什么呀对	other
啊哦啊哦	other
我一个人还是一个文件啊哦	other
我们又多一姐她没有存	other
他是哦对他是个签名	other
看着没有这个是蓝牙连接的问题	other
这是对吧这个卡不是纯粹的问题就是你这个	other
他的她和这个设备的连接它它不稳定	other
不错	other
虽然生活变得很快	other
不是我觉得发生一定要其实	other
啊你不是说什么病都不会说话	other
一玩耍哦	other
我就是你要有用	other
如果阿森纳很可爱	other
那我就自己有可能	other
如果你的27	other
我知道所以说现在真的	other
我因为我们也有我们已经快要放假了	other
哦诶	other
嗯等一下出来吧嗯我是说	other
这是说好尴尬哦我和这个数据打脸了哦	other
可是这个男人为什么搞个女生	other
全部关了吗她说妈妈很累	other
帮我查看规则	other
你是新启一个窗口但是但是	other
是这样的啊	other
你过来了吗	other
大伯不好玩啊	other
没有	other
那我靠我一直哦诶	other
不我你不用管就说他	other
试一下就独独就	other
先说烦啊	other
不舒服哦	other
但是这到底是	other
上海呢哦	other
所以要写	other
那我也不想的啊	other
不用我还不是一次另外成就在实现似乎	other
他一定成功我也是我没有路好可惜了妈的	other
老师说我操啊说说啊	other
这也太坑了吧我这是谁这么	other
想他们但如果乱起了这个	other
那可以了吗	other
人性	other
追加吗就算人家剩女哦	other
实现眼屎吧可能是	other
不是我的意思如果他没	other
不想交代一下没没事一下下	other
多好啊	other
这个卖	other
我就退了因为他有一个	other
就是可以叠加是吧他在这在	other
你打	other
有反应啊	other
呃我要查诶	other
啊这个不是说过吗	other
讲的时候要小心点膘了他这个	other
对她其实是听的是我说的话对	other
对我我哦	other
这个距离是还挺安全的	other
但是我的	other
诶还可以啊小海小海	other
还挺近呢所以说你那点而已只要你不说我还就不说话不过我好像那个	other
对就是那个置信度就是要把它调高一点不要我们说什么话他都能命中这就有点奇怪因为他讲的时候有可能会讲解对对对那那个洋妞反正我这	other
他就回答了想要命中了这就很尴尬	other
其他好像没有了好像留着对着我在看一下	other
那边有那个脚本的吗现在	other
行诶	other
没有	other
到了那个从头到尾	other
你说第一条第一条指令	other
这样你这不远了也能识别因为我可悲	other
我跟他在一起	other
就是这么会流出来第一	other
就90楼带着往前面的包括好可怜	other
他说得	other
红军说一下哦累	other
许多回答晚了	other
报了也没关系就是比如说我们说了那句他出错了没反应你再重复一句然后他又能执行我还能这反而体现我们的真	other
甄嬛反而不真实	other
那么我应该可以优化和调整不破了之后后面再把它顺一下诶哦诶哦	other
对我来看一下哪哪个地方会卡咳然后问你哪个地方网站优化六万	other
机长了是在哪里呀现在	other
还是在哪里呀诶哦这事儿吗	other
他这个我看一下语音搜索有没有语音搜索如果没有关系的话权益咋还能夹它只要识别对了就行	other
嗯嗯	other
不要转移出来丢脸	other
想想以前还	other
想一下诶	other
他好像有个那个就是他这句话说完之后	other
我错了没啊	other
哎呀好像这是出错了	other
现在又发过去了当官就是没谱啊	other
我打开	other
这话实在是命中得拜名师	other
啊哈啊哈	other
一点事情都到处游玩	other
嗯嗯唉自己刺	other
逛了	other
啊哦	other
俗话说	other
你别这样说	other
行行行	other
可以	other
那就这样吧	other
